NO ./textures/planks.xpm

SO ./textures/purplestone.xpm


F 0,255,0

WE ./textures/94B68D67-F38A-48A2-808B-B97C9116898B_1_.xpm

EA ./textures/wood.xpm

C 0,0,255







   1111111111
   1111000001
   1110000011
  1100000111
 100N001111
1000010101
1000000001
1011110011
1000000001
1111111111
