NO ./textures/north

SO ./textures/south


F 0,255,0


WE ./textures/west
F 250,255,145
EA ./textures/east



C 0,0,255





   1111111111
   1111000001
   1110000011
  1100000111
 1000001111
1000010101
10000E0001
1011110011
1000000001
1111111111
