NO ./textures/north

SO ./textures/south


F 0,255,0

WE ./textures/west

EA ./textures/east

C 0,0,255







   1111111111
   1111000001
   1110000011
  1100N00111
 1000001111
10S0010101
1000000001
1011110011
1000000001
1111111111
