1111111111
1010000001
1010000001
1010001001
1010000001
1000000001
1000001101
1000001101
1000000001
1111111111
