1111111111
1000000001111111
1011101100000001
1010000100000111
10101101010111
101000010111
1011111101
1000000001
1011111101
1111111111
