NO ./textures/north

SO ./textures/south


F 0,255,0

WE ./textures/west

EA ./textures/east

C 0,0,255

   111111111111111111111111111111111111
   100000000000000000000000000000000001
   100000000000000000000000000000000001
   100000000000000000000000000000000001
   100000000000000000000000000000000001
   100000000000000000000000000000000001
   100000000000000000000000000000000001
   100000000000000000000000000000000001
   100000000000000000000000000000000001
   100000000000000000000000000000000001
   100000000000000000000000000000000001
   1000000000000000000000000000000S0001
   100000000000000000000000000011111101
   100000000000000000000000000011111101
   100000000000000000000000000011111101
   111111111111111111111111111111111111
